R 1280 720

NO ./textures/walls/colorstone.xpm
SO ./textures/walls/greystone.xpm
WE ./textures/walls/mossy.xpm
EA ./textures/walls/wood.xpm

S ./textures/sprites/barrel.xp
F 112,128,144
C 0,191,255

        1111111111111111111111111
        1000000000110000000000001
        1011000001110000000200001
        1001000000000000000000001
111111111011000001110000200000001
100000000011000001110111111111111
11110111111111011100000010001    
11110111111111011101010010001    
11000000112121011100020010001    
10000000000000000000000000001    
10020000000000011010100100001    
1100000111011101111101111000111  
1111N111 111 101 101111010001    
11111111 111 111 111111111111    


101

