R 1280 720

NO ./textures/walls/colorstone.xpm
SO ./textures/walls/greystone.xpm
WE ./textures/walls/mossy.xpm
EA ./textures/walls/wood.xpm

S ./textures/sprites/barrel.xpm
F 112,128,144
C 		0,191,255

        1111111111111111111111111
        100000000011N000000000001
111111111111111111111111111111111



