R 1280 720

NO ./textures/walls/colorstone.xpm
SO ./textures/walls/greystone.xpm
WE ./textures/walls/mossy.xpm
EA ./textures/walls/wood.xpm

S ./textures/sprites/barrel.xpm
F 128,255,0
C 0,255,255

111111111111111111111
10000000000  0000000001
100000000000000000001
100000000000  000	000001
10   0000  000000000000001
10000000000E000000001
1000000  00000000000001
111111111111111111111