R 1280 1080

NO ./textures/walls/colorstone.xpm
SO ./textures/walls/greystone.xpm
WE ./textures/walls/mossy.xpm
EA ./textures/walls/wood.xpm

S ./textures/sprites/barrel.xpm

C 0,255,255
F 128,255,0

111111111111111111
101100000010000001
100001011000101101
110111001101100101
100001100100101111
101101101110100001
100101100210111101
110100111010001101
110110100N11100001
110010001110001011
111010100010111011
100010111011100001
101110001000111111
100011011110000001
111111111111111111