
S ./textures/sprites/barrel.xpm
SO ./textures/walls/leaf_block.xpm
EA ./textures/walls/leaf_block.xpm

C 135, 206,235
F 75, 122, 71
WE ./textures/walls/leaf_block.xpm
NO ./textures/walls/leaf_block.xpm

R 1000 500


111111111111111
120000001000001
101110101010111
100010101010001
111110111011101
100000000010001
101010111010111
101010001010001
101011101011101
101000101010101
101110111010101
1000100010001N1
111111111111111