R	1920	1080

NO	./textures/stone.xpm
SO	./textures/stone.xpm
EA	./textures/wood.xpm
WE	./textures/wood.xpm

S	./textures/brick.xpm

C	4, 127, 253
F	156, 94, 47

1111111
1001001
1000001
1000001
100N001
1000001
1000001
1001001
1111111